Year,School,Total,Male,Female,Type,Ownership
103,中原大學,442,372,70,General,Private
103,中國文化大學,459,396,63,General,Private
103,中國科技大學,178,170,8,Tech,Private
103,中華大學,393,341,52,General,Private
103,中華科技大學,348,316,32,Tech,Private
103,亞洲大學,378,345,33,General,Private
103,健行科技大學,869,799,70,Tech,Private
103,元培醫事科技大學,287,274,13,Tech,Private
103,南榮科技大學,13,13,0,Tech,Private
103,南臺科技大學,466,421,45,Tech,Private
103,南華大學,237,201,36,General,Private
103,吳鳳科技大學,193,181,12,Tech,Private
103,和春技術學院,64,62,2,Tech,Private
103,國立中央大學,441,364,77,General,Public
103,國立中山大學,213,176,37,General,Public
103,國立中正大學,395,328,67,General,Public
103,國立勤益科技大學,446,409,37,Tech,Public
103,國立嘉義大學,204,179,25,General,Public
103,國立宜蘭大學,175,149,26,General,Public
103,國立屏東大學,213,194,19,General,Public
103,國立彰化師範大學,162,128,34,General,Public
103,國立成功大學,435,353,82,General,Public
103,國立暨南國際大學,217,166,51,General,Public
103,國立東華大學,192,154,38,General,Public
103,國立清華大學,534,418,116,General,Public
103,國立澎湖科技大學,193,181,12,Tech,Public
103,國立聯合大學,196,165,31,General,Public
103,國立臺中教育大學,206,162,44,General,Public
103,國立臺中科技大學,206,185,21,Tech,Public
103,國立臺北大學,196,156,40,General,Public
103,國立臺北科技大學,207,184,23,Tech,Public
103,國立臺南大學,157,124,33,General,Public
103,國立臺東大學,366,292,74,General,Public
103,國立臺灣大學,500,418,82,General,Public
103,國立臺灣海洋大學,459,389,70,General,Public
103,國立臺灣科技大學,231,206,25,Tech,Public
103,國立虎尾科技大學,428,397,31,Tech,Public
103,國立金門大學,189,157,32,General,Public
103,國立陽明交通大學,781,604,177,General,Public
103,國立雲林科技大學,249,231,18,Tech,Public
103,國立高雄大學,168,140,28,General,Public
103,國立高雄科技大學,221,201,20,Tech,Public
103,大仁科技大學,100,98,2,Tech,Private
103,大同大學,412,344,68,General,Private
103,大葉大學,281,252,29,General,Private
103,崑山科技大學,405,376,29,Tech,Private
103,宏國德霖科技大學,288,279,9,Tech,Private
103,明新科技大學,482,446,36,Tech,Private
103,景文科技大學,197,179,18,Tech,Private
103,朝陽科技大學,481,459,22,Tech,Private
103,東海大學,509,385,124,General,Private
103,南亞技術學院,217,210,7,Tech,Private
103,樹德科技大學,436,397,39,Tech,Private
103,正修科技大學,449,421,28,Tech,Private
103,真理大學,360,295,65,General,Private
103,義守大學,545,483,62,General,Private
103,聖約翰科技大學,449,429,20,Tech,Private
103,臺北城市科技大學,519,503,16,Tech,Private
103,華夏科技大學,323,308,15,Tech,Private
103,萬能科技大學,354,339,15,Tech,Private
103,輔仁大學,500,436,64,General,Private
103,逢甲大學,849,749,100,General,Private
103,遠東科技大學,400,383,17,Tech,Private
103,長榮大學,313,269,44,General,Private
103,靜宜大學,438,376,62,General,Private
104,中原大學,429,362,67,General,Private
104,中國文化大學,483,424,59,General,Private
104,中國科技大學,159,149,10,Tech,Private
104,中華大學,401,356,45,General,Private
104,中華科技大學,298,266,32,Tech,Private
104,亞洲大學,367,332,35,General,Private
104,健行科技大學,795,731,64,Tech,Private
104,元培醫事科技大學,211,205,6,Tech,Private
104,元智大學,656,531,125,General,Private
104,南榮科技大學,3,3,0,Tech,Private
104,南臺科技大學,450,406,44,Tech,Private
104,南華大學,269,238,31,General,Private
104,吳鳳科技大學,172,157,15,Tech,Private
104,和春技術學院,48,46,2,Tech,Private
104,國立中央大學,456,374,82,General,Public
104,國立中山大學,220,190,30,General,Public
104,國立中正大學,381,326,55,General,Public
104,國立勤益科技大學,488,455,33,Tech,Public
104,國立嘉義大學,205,182,23,General,Public
104,國立宜蘭大學,185,167,18,General,Public
104,國立屏東大學,222,203,19,General,Public
104,國立彰化師範大學,162,127,35,General,Public
104,國立成功大學,445,359,86,General,Public
104,國立暨南國際大學,228,169,59,General,Public
104,國立東華大學,281,222,59,General,Public
104,國立清華大學,558,451,107,General,Public
104,國立澎湖科技大學,192,179,13,Tech,Public
104,國立聯合大學,178,153,25,General,Public
104,國立臺中教育大學,199,160,39,General,Public
104,國立臺中科技大學,205,191,14,Tech,Public
104,國立臺北大學,193,157,36,General,Public
104,國立臺北科技大學,209,182,27,Tech,Public
104,國立臺南大學,166,129,37,General,Public
104,國立臺東大學,367,296,71,General,Public
104,國立臺灣大學,511,439,72,General,Public
104,國立臺灣師範大學,185,134,51,General,Public
104,國立臺灣海洋大學,472,391,81,General,Public
104,國立臺灣科技大學,247,217,30,Tech,Public
104,國立虎尾科技大學,414,382,32,Tech,Public
104,國立金門大學,185,159,26,General,Public
104,國立陽明交通大學,789,623,166,General,Public
104,國立雲林科技大學,245,226,19,Tech,Public
104,國立高雄大學,174,150,24,General,Public
104,國立高雄科技大學,231,214,17,Tech,Public
104,大同大學,411,349,62,General,Private
104,大葉大學,231,209,22,General,Private
104,崑山科技大學,379,352,27,Tech,Private
104,弘光科技大學,341,330,11,Tech,Private
104,宏國德霖科技大學,261,254,7,Tech,Private
104,明新科技大學,462,425,37,Tech,Private
104,景文科技大學,187,176,11,Tech,Private
104,朝陽科技大學,498,478,20,Tech,Private
104,東海大學,515,396,119,General,Private
104,南亞技術學院,135,133,2,Tech,Private
104,樹德科技大學,437,402,35,Tech,Private
104,正修科技大學,431,403,28,Tech,Private
104,淡江大學,794,680,114,General,Private
104,真理大學,366,291,75,General,Private
104,義守大學,504,453,51,General,Private
104,聖約翰科技大學,423,400,23,Tech,Private
104,臺北城市科技大學,498,481,17,Tech,Private
104,華夏科技大學,305,294,11,Tech,Private
104,萬能科技大學,339,318,21,Tech,Private
104,輔仁大學,505,425,80,General,Private
104,逢甲大學,858,763,95,General,Private
104,遠東科技大學,346,335,11,Tech,Private
104,銘傳大學,430,352,78,General,Private
104,長庚大學,225,172,53,General,Private
104,長榮大學,317,276,41,General,Private
104,靜宜大學,456,382,74,General,Private
105,中原大學,444,376,68,General,Private
105,中國文化大學,465,406,59,General,Private
105,中國科技大學,146,134,12,Tech,Private
105,中華科技大學,202,175,27,Tech,Private
105,健行科技大學,653,610,43,Tech,Private
105,元智大學,630,511,119,General,Private
105,南亞技術學院,114,110,4,Tech,Private
105,南臺科技大學,447,403,44,Tech,Private
105,南華大學,248,216,32,General,Private
105,吳鳳科技大學,150,138,12,Tech,Private
105,和春技術學院,47,33,14,Tech,Private
105,國立中央大學,475,383,92,General,Public
105,國立中山大學,234,200,34,General,Public
105,國立中正大學,385,332,53,General,Public
105,國立勤益科技大學,525,486,39,Tech,Public
105,國立嘉義大學,212,184,28,General,Public
105,國立宜蘭大學,189,170,19,General,Public
105,國立屏東大學,229,208,21,General,Public
105,國立彰化師範大學,162,128,34,General,Public
105,國立成功大學,461,355,106,General,Public
105,國立暨南國際大學,232,179,53,General,Public
105,國立清華大學,565,445,120,General,Public
105,國立澎湖科技大學,198,180,18,Tech,Public
105,國立聯合大學,176,154,22,General,Public
105,國立臺中教育大學,198,163,35,General,Public
105,國立臺中科技大學,205,191,14,Tech,Public
105,國立臺北大學,200,153,47,General,Public
105,國立臺北科技大學,204,176,28,Tech,Public
105,國立臺南大學,161,124,37,General,Public
105,國立臺東大學,350,286,64,General,Public
105,國立臺灣大學,520,455,65,General,Public
105,國立臺灣師範大學,193,149,44,General,Public
105,國立臺灣海洋大學,464,385,79,General,Public
105,國立臺灣科技大學,265,230,35,Tech,Public
105,國立虎尾科技大學,426,395,31,Tech,Public
105,國立金門大學,183,163,20,General,Public
105,國立雲林科技大學,244,221,23,Tech,Public
105,國立高雄大學,180,152,28,General,Public
105,國立高雄科技大學,238,221,17,Tech,Public
105,大同大學,437,356,81,General,Private
105,大葉大學,215,197,18,General,Private
105,崑山科技大學,359,335,24,Tech,Private
105,弘光科技大學,345,333,12,Tech,Private
105,宏國德霖科技大學,229,222,7,Tech,Private
105,明新科技大學,463,427,36,Tech,Private
105,景文科技大學,166,158,8,Tech,Private
105,朝陽科技大學,493,469,24,Tech,Private
105,樹德科技大學,437,399,38,Tech,Private
105,正修科技大學,429,411,18,Tech,Private
105,淡江大學,765,646,119,General,Private
105,真理大學,344,271,73,General,Private
105,義守大學,477,429,48,General,Private
105,聖約翰科技大學,340,325,15,Tech,Private
105,臺北城市科技大學,451,437,14,Tech,Private
105,華夏科技大學,252,248,4,Tech,Private
105,萬能科技大學,286,265,21,Tech,Private
105,輔仁大學,485,399,86,General,Private
105,逢甲大學,929,827,102,General,Private
105,遠東科技大學,312,301,11,Tech,Private
105,銘傳大學,428,344,84,General,Private
105,長庚大學,232,179,53,General,Private
105,長榮大學,279,239,40,General,Private
105,靜宜大學,439,365,74,General,Private
106,中原大學,456,385,71,General,Private
106,中國文化大學,485,431,54,General,Private
106,中國科技大學,117,106,11,Tech,Private
106,中華大學,386,334,52,General,Private
106,中華科技大學,134,113,21,Tech,Private
106,亞洲大學,345,303,42,General,Private
106,健行科技大學,578,542,36,Tech,Private
106,元智大學,632,506,126,General,Private
106,南亞技術學院,91,87,4,Tech,Private
106,南臺科技大學,445,403,42,Tech,Private
106,南華大學,239,209,30,General,Private
106,吳鳳科技大學,138,124,14,Tech,Private
106,和春技術學院,14,14,0,Tech,Private
106,國立中央大學,475,370,105,General,Public
106,國立中山大學,235,196,39,General,Public
106,國立中正大學,386,326,60,General,Public
106,國立勤益科技大學,578,533,45,Tech,Public
106,國立嘉義大學,206,170,36,General,Public
106,國立宜蘭大學,190,170,20,General,Public
106,國立屏東大學,225,200,25,General,Public
106,國立彰化師範大學,174,135,39,General,Public
106,國立成功大學,460,350,110,General,Public
106,國立暨南國際大學,234,186,48,General,Public
106,國立東華大學,314,245,69,General,Public
106,國立清華大學,579,453,126,General,Public
106,國立澎湖科技大學,200,186,14,Tech,Public
106,國立聯合大學,168,150,18,General,Public
106,國立臺中教育大學,195,154,41,General,Public
106,國立臺中科技大學,221,206,15,Tech,Public
106,國立臺北大學,199,155,44,General,Public
106,國立臺北科技大學,202,176,26,Tech,Public
106,國立臺南大學,168,127,41,General,Public
106,國立臺東大學,364,304,60,General,Public
106,國立臺灣大學,526,461,65,General,Public
106,國立臺灣師範大學,202,164,38,General,Public
106,國立臺灣海洋大學,463,379,84,General,Public
106,國立臺灣科技大學,291,256,35,Tech,Public
106,國立虎尾科技大學,426,398,28,Tech,Public
106,國立金門大學,179,154,25,General,Public
106,國立陽明交通大學,797,643,154,General,Public
106,國立雲林科技大學,259,233,26,Tech,Public
106,國立高雄大學,173,138,35,General,Public
106,大同大學,435,346,89,General,Private
106,大葉大學,189,178,11,General,Private
106,宏國德霖科技大學,206,201,5,Tech,Private
106,崑山科技大學,313,293,20,Tech,Private
106,弘光科技大學,308,294,14,Tech,Private
106,明新科技大學,481,439,42,Tech,Private
106,景文科技大學,163,156,7,Tech,Private
106,朝陽科技大學,491,471,20,Tech,Private
106,東海大學,521,389,132,General,Private
106,樹德科技大學,379,353,26,Tech,Private
106,正修科技大學,474,425,49,Tech,Private
106,淡江大學,735,630,105,General,Private
106,真理大學,312,245,67,General,Private
106,義守大學,425,379,46,General,Private
106,聖約翰科技大學,242,224,18,Tech,Private
106,臺北城市科技大學,447,428,19,Tech,Private
106,華夏科技大學,246,233,13,Tech,Private
106,萬能科技大學,247,233,14,Tech,Private
106,輔仁大學,484,396,88,General,Private
106,逢甲大學,932,797,135,General,Private
106,遠東科技大學,245,233,12,Tech,Private
106,銘傳大學,444,364,80,General,Private
106,長庚大學,234,178,56,General,Private
106,長榮大學,242,216,26,General,Private
106,靜宜大學,447,367,80,General,Private
107,中原大學,473,386,87,General,Private
107,中國文化大學,451,404,47,General,Private
107,中國科技大學,113,99,14,Tech,Private
107,中華大學,391,343,48,General,Private
107,中華科技大學,53,47,6,Tech,Private
107,亞洲大學,334,294,40,General,Private
107,健行科技大學,527,499,28,Tech,Private
107,元智大學,624,493,131,General,Private
107,南亞技術學院,99,91,8,Tech,Private
107,南臺科技大學,440,390,50,Tech,Private
107,南華大學,250,218,32,General,Private
107,吳鳳科技大學,82,78,4,Tech,Private
107,和春技術學院,4,4,0,Tech,Private
107,國立中央大學,471,368,103,General,Public
107,國立中山大學,246,203,43,General,Public
107,國立中正大學,400,326,74,General,Public
107,國立勤益科技大學,566,522,44,Tech,Public
107,國立嘉義大學,202,169,33,General,Public
107,國立宜蘭大學,185,157,28,General,Public
107,國立屏東大學,212,194,18,General,Public
107,國立彰化師範大學,185,146,39,General,Public
107,國立成功大學,478,364,114,General,Public
107,國立暨南國際大學,224,174,50,General,Public
107,國立東華大學,332,258,74,General,Public
107,國立清華大學,584,445,139,General,Public
107,國立澎湖科技大學,205,191,14,Tech,Public
107,國立聯合大學,157,136,21,General,Public
107,國立臺中教育大學,194,154,40,General,Public
107,國立臺中科技大學,236,214,22,Tech,Public
107,國立臺北大學,197,155,42,General,Public
107,國立臺北科技大學,215,191,24,Tech,Public
107,國立臺南大學,166,131,35,General,Public
107,國立臺東大學,335,275,60,General,Public
107,國立臺灣大學,554,485,69,General,Public
107,國立臺灣師範大學,201,161,40,General,Public
107,國立臺灣海洋大學,457,372,85,General,Public
107,國立臺灣科技大學,326,281,45,Tech,Public
107,國立虎尾科技大學,425,398,27,Tech,Public
107,國立金門大學,159,132,27,General,Public
107,國立陽明交通大學,781,629,152,General,Public
107,國立雲林科技大學,260,232,28,Tech,Public
107,國立高雄大學,182,144,38,General,Public
107,大同大學,436,335,101,General,Private
107,大葉大學,170,159,11,General,Private
107,宏國德霖科技大學,197,191,6,Tech,Private
107,崑山科技大學,296,277,19,Tech,Private
107,弘光科技大學,301,277,24,Tech,Private
107,明新科技大學,439,425,14,Tech,Private
107,景文科技大學,153,144,9,Tech,Private
107,朝陽科技大學,483,464,19,Tech,Private
107,東海大學,524,398,126,General,Private
107,樹德科技大學,385,360,25,Tech,Private
107,正修科技大學,413,399,14,Tech,Private
107,淡江大學,711,599,112,General,Private
107,真理大學,304,245,59,General,Private
107,義守大學,410,354,56,General,Private
107,聖約翰科技大學,185,168,17,Tech,Private
107,臺北城市科技大學,399,381,18,Tech,Private
107,華夏科技大學,166,162,4,Tech,Private
107,萬能科技大學,217,205,12,Tech,Private
107,輔仁大學,477,373,104,General,Private
107,逢甲大學,943,792,151,General,Private
107,遠東科技大學,231,219,12,Tech,Private
107,銘傳大學,426,339,87,General,Private
107,長庚大學,218,160,58,General,Private
107,長榮大學,228,201,27,General,Private
107,靜宜大學,467,389,78,General,Private
108,中原大學,483,368,115,General,Private
108,中國文化大學,437,385,52,General,Private
108,中國科技大學,118,106,12,Tech,Private
108,中華大學,370,318,52,General,Private
108,中華科技大學,6,6,0,Tech,Private
108,亞洲大學,318,277,41,General,Private
108,健行科技大學,530,508,22,Tech,Private
108,元智大學,627,472,155,General,Private
108,南亞技術學院,119,110,9,Tech,Private
108,南臺科技大學,473,405,68,Tech,Private
108,南華大學,262,217,45,General,Private
108,吳鳳科技大學,45,45,0,Tech,Private
108,和春技術學院,3,3,0,Tech,Private
108,國立中央大學,446,340,106,General,Public
108,國立中山大學,238,193,45,General,Public
108,國立中正大學,390,300,90,General,Public
108,國立勤益科技大學,573,514,59,Tech,Public
108,國立嘉義大學,199,158,41,General,Public
108,國立宜蘭大學,176,145,31,General,Public
108,國立屏東大學,211,198,13,General,Public
108,國立彰化師範大學,181,142,39,General,Public
108,國立成功大學,466,364,102,General,Public
108,國立暨南國際大學,218,165,53,General,Public
108,國立東華大學,359,278,81,General,Public
108,國立清華大學,574,432,142,General,Public
108,國立澎湖科技大學,212,199,13,Tech,Public
108,國立聯合大學,170,141,29,General,Public
108,國立臺中教育大學,203,163,40,General,Public
108,國立臺中科技大學,254,236,18,Tech,Public
108,國立臺北大學,199,154,45,General,Public
108,國立臺北科技大學,224,198,26,Tech,Public
108,國立臺南大學,159,121,38,General,Public
108,國立臺東大學,335,265,70,General,Public
108,國立臺灣大學,556,481,75,General,Public
108,國立臺灣師範大學,219,169,50,General,Public
108,國立臺灣海洋大學,459,373,86,General,Public
108,國立臺灣科技大學,355,301,54,Tech,Public
108,國立虎尾科技大學,431,402,29,Tech,Public
108,國立金門大學,171,141,30,General,Public
108,國立陽明交通大學,778,612,166,General,Public
108,國立雲林科技大學,283,256,27,Tech,Public
108,國立高雄大學,185,141,44,General,Public
108,國立高雄科技大學,241,227,14,Tech,Public
108,大同大學,445,335,110,General,Private
108,大葉大學,146,138,8,General,Private
108,宏國德霖科技大學,162,158,4,Tech,Private
108,崑山科技大學,306,281,25,Tech,Private
108,弘光科技大學,301,267,34,Tech,Private
108,明新科技大學,454,434,20,Tech,Private
108,景文科技大學,141,131,10,Tech,Private
108,朝陽科技大學,480,458,22,Tech,Private
108,東海大學,530,387,143,General,Private
108,樹德科技大學,345,316,29,Tech,Private
108,正修科技大學,381,367,14,Tech,Private
108,淡江大學,721,600,121,General,Private
108,真理大學,284,229,55,General,Private
108,義守大學,407,348,59,General,Private
108,聖約翰科技大學,141,124,17,Tech,Private
108,臺北城市科技大學,371,359,12,Tech,Private
108,華夏科技大學,140,135,5,Tech,Private
108,萬能科技大學,208,193,15,Tech,Private
108,輔仁大學,486,368,118,General,Private
108,逢甲大學,989,807,182,General,Private
108,遠東科技大學,212,196,16,Tech,Private
108,銘傳大學,421,332,89,General,Private
108,長庚大學,224,158,66,General,Private
108,長榮大學,160,135,25,General,Private
108,靜宜大學,459,383,76,General,Private
109,中原大學,479,357,122,General,Private
109,中國文化大學,447,394,53,General,Private
109,中國科技大學,137,123,14,Tech,Private
109,中華大學,382,321,61,General,Private
109,中華科技大學,1,1,0,Tech,Private
109,亞洲大學,479,412,67,General,Private
109,健行科技大學,546,523,23,Tech,Private
109,元智大學,650,474,176,General,Private
109,南亞技術學院,144,130,14,Tech,Private
109,南臺科技大學,523,452,71,Tech,Private
109,南華大學,308,253,55,General,Private
109,吳鳳科技大學,16,16,0,Tech,Private
109,國立中央大學,414,300,114,General,Public
109,國立中山大學,239,190,49,General,Public
109,國立中正大學,397,300,97,General,Public
109,國立勤益科技大學,586,527,59,Tech,Public
109,國立嘉義大學,206,157,49,General,Public
109,國立宜蘭大學,188,148,40,General,Public
109,國立屏東大學,229,205,24,General,Public
109,國立彰化師範大學,191,147,44,General,Public
109,國立成功大學,463,371,92,General,Public
109,國立暨南國際大學,224,172,52,General,Public
109,國立東華大學,390,289,101,General,Public
109,國立清華大學,584,435,149,General,Public
109,國立澎湖科技大學,226,211,15,Tech,Public
109,國立聯合大學,172,137,35,General,Public
109,國立臺中教育大學,199,157,42,General,Public
109,國立臺中科技大學,302,275,27,Tech,Public
109,國立臺北大學,199,161,38,General,Public
109,國立臺北科技大學,238,213,25,Tech,Public
109,國立臺南大學,168,129,39,General,Public
109,國立臺東大學,344,270,74,General,Public
109,國立臺灣大學,582,497,85,General,Public
109,國立臺灣師範大學,245,192,53,General,Public
109,國立臺灣海洋大學,488,387,101,General,Public
109,國立臺灣科技大學,384,329,55,Tech,Public
109,國立虎尾科技大學,453,420,33,Tech,Public
109,國立金門大學,174,138,36,General,Public
109,國立雲林科技大學,277,254,23,Tech,Public
109,國立高雄大學,189,143,46,General,Public
109,國立高雄科技大學,259,241,18,Tech,Public
109,大同大學,444,336,108,General,Private
109,大葉大學,137,123,14,General,Private
109,宏國德霖科技大學,128,121,7,Tech,Private
109,崑山科技大學,271,250,21,Tech,Private
109,弘光科技大學,285,249,36,Tech,Private
109,明新科技大學,418,400,18,Tech,Private
109,景文科技大學,143,134,9,Tech,Private
109,朝陽科技大學,492,465,27,Tech,Private
109,東海大學,564,412,152,General,Private
109,樹德科技大學,295,274,21,Tech,Private
109,正修科技大學,348,332,16,Tech,Private
109,淡江大學,777,646,131,General,Private
109,真理大學,242,194,48,General,Private
109,義守大學,417,358,59,General,Private
109,聖約翰科技大學,130,112,18,Tech,Private
109,臺北城市科技大學,388,374,14,Tech,Private
109,華夏科技大學,136,120,16,Tech,Private
109,萬能科技大學,236,218,18,Tech,Private
109,輔仁大學,503,368,135,General,Private
109,逢甲大學,1028,828,200,General,Private
109,遠東科技大學,182,169,13,Tech,Private
109,銘傳大學,421,332,89,General,Private
109,長庚大學,240,169,71,General,Private
109,長榮大學,172,140,32,General,Private
109,靜宜大學,477,385,92,General,Private
110,中原大學,518,374,144,General,Private
110,中國文化大學,465,399,66,General,Private
110,中國科技大學,185,166,19,Tech,Private
110,中華大學,437,363,74,General,Private
110,中華科技大學,3,3,0,Tech,Private
110,亞洲大學,482,408,74,General,Private
110,健行科技大學,521,497,24,Tech,Private
110,元智大學,652,468,184,General,Private
110,南亞技術學院,153,137,16,Tech,Private
110,南臺科技大學,564,488,76,Tech,Private
110,南華大學,337,270,67,General,Private
110,國立中央大學,413,309,104,General,Public
110,國立中山大學,237,192,45,General,Public
110,國立中正大學,403,306,97,General,Public
110,國立勤益科技大學,624,548,76,Tech,Public
110,國立嘉義大學,216,160,56,General,Public
110,國立宜蘭大學,202,156,46,General,Public
110,國立屏東大學,260,231,29,General,Public
110,國立彰化師範大學,207,158,49,General,Public
110,國立成功大學,493,400,93,General,Public
110,國立暨南國際大學,237,186,51,General,Public
110,國立東華大學,436,307,129,General,Public
110,國立清華大學,596,443,153,General,Public
110,國立澎湖科技大學,227,210,17,Tech,Public
110,國立聯合大學,193,152,41,General,Public
110,國立臺中教育大學,202,150,52,General,Public
110,國立臺中科技大學,326,287,39,Tech,Public
110,國立臺北大學,221,180,41,General,Public
110,國立臺北科技大學,245,218,27,Tech,Public
110,國立臺南大學,178,133,45,General,Public
110,國立臺東大學,368,282,86,General,Public
110,國立臺灣大學,588,495,93,General,Public
110,國立臺灣師範大學,237,181,56,General,Public
110,國立臺灣海洋大學,505,392,113,General,Public
110,國立臺灣科技大學,400,342,58,Tech,Public
110,國立虎尾科技大學,446,408,38,Tech,Public
110,國立金門大學,188,149,39,General,Public
110,國立陽明交通大學,819,645,174,General,Public
110,國立雲林科技大學,294,273,21,Tech,Public
110,國立高雄大學,194,151,43,General,Public
110,國立高雄科技大學,282,262,20,Tech,Public
110,大同大學,466,362,104,General,Private
110,大葉大學,142,127,15,General,Private
110,宏國德霖科技大學,124,115,9,Tech,Private
110,崑山科技大學,261,244,17,Tech,Private
110,弘光科技大學,304,267,37,Tech,Private
110,明新科技大學,391,367,24,Tech,Private
110,景文科技大學,118,106,12,Tech,Private
110,朝陽科技大學,450,416,34,Tech,Private
110,東海大學,581,434,147,General,Private
110,樹德科技大學,277,258,19,Tech,Private
110,正修科技大學,354,341,13,Tech,Private
110,淡江大學,814,670,144,General,Private
110,真理大學,247,200,47,General,Private
110,義守大學,452,376,76,General,Private
110,聖約翰科技大學,76,69,7,Tech,Private
110,臺北城市科技大學,430,406,24,Tech,Private
110,華夏科技大學,111,99,12,Tech,Private
110,萬能科技大學,264,247,17,Tech,Private
110,輔仁大學,533,374,159,General,Private
110,逢甲大學,1043,822,221,General,Private
110,遠東科技大學,144,135,9,Tech,Private
110,銘傳大學,451,344,107,General,Private
110,長庚大學,241,168,73,General,Private
110,長榮大學,183,152,31,General,Private
110,靜宜大學,504,407,97,General,Private
111,中原大學,506,363,143,General,Private
111,中國文化大學,437,373,64,General,Private
111,中國科技大學,213,190,23,Tech,Private
111,中華大學,447,376,71,General,Private
111,亞洲大學,481,401,80,General,Private
111,健行科技大學,465,443,22,Tech,Private
111,元智大學,655,463,192,General,Private
111,南亞技術學院,178,157,21,Tech,Private
111,南臺科技大學,609,542,67,Tech,Private
111,南華大學,337,262,75,General,Private
111,國立中央大學,416,314,102,General,Public
111,國立中山大學,242,202,40,General,Public
111,國立中正大學,406,312,94,General,Public
111,國立中興大學,150,107,43,General,Public
111,國立勤益科技大學,648,569,79,Tech,Public
111,國立嘉義大學,230,163,67,General,Public
111,國立宜蘭大學,202,160,42,General,Public
111,國立屏東大學,302,263,39,General,Public
111,國立彰化師範大學,210,163,47,General,Public
111,國立成功大學,499,408,91,General,Public
111,國立暨南國際大學,241,186,55,General,Public
111,國立東華大學,481,337,144,General,Public
111,國立清華大學,590,444,146,General,Public
111,國立澎湖科技大學,235,216,19,Tech,Public
111,國立聯合大學,190,154,36,General,Public
111,國立臺中教育大學,207,151,56,General,Public
111,國立臺中科技大學,347,296,51,Tech,Public
111,國立臺北大學,223,185,38,General,Public
111,國立臺北科技大學,250,219,31,Tech,Public
111,國立臺南大學,186,136,50,General,Public
111,國立臺東大學,381,285,96,General,Public
111,國立臺灣大學,590,493,97,General,Public
111,國立臺灣師範大學,252,191,61,General,Public
111,國立臺灣海洋大學,509,395,114,General,Public
111,國立臺灣科技大學,393,333,60,Tech,Public
111,國立虎尾科技大學,449,406,43,Tech,Public
111,國立金門大學,210,158,52,General,Public
111,國立陽明交通大學,812,640,172,General,Public
111,國立雲林科技大學,284,265,19,Tech,Public
111,國立高雄大學,195,150,45,General,Public
111,國立高雄科技大學,290,268,22,Tech,Public
111,大同大學,505,401,104,General,Private
111,大葉大學,119,107,12,General,Private
111,宏國德霖科技大學,112,98,14,Tech,Private
111,崑山科技大學,199,182,17,Tech,Private
111,明新科技大學,359,332,27,Tech,Private
111,景文科技大學,81,73,8,Tech,Private
111,朝陽科技大學,451,425,26,Tech,Private
111,東海大學,625,471,154,General,Private
111,樹德科技大學,228,216,12,Tech,Private
111,正修科技大學,324,310,14,Tech,Private
111,淡江大學,825,681,144,General,Private
111,真理大學,222,177,45,General,Private
111,義守大學,472,390,82,General,Private
111,聖約翰科技大學,57,49,8,Tech,Private
111,臺北城市科技大學,360,341,19,Tech,Private
111,華夏科技大學,90,79,11,Tech,Private
111,萬能科技大學,276,258,18,Tech,Private
111,輔仁大學,549,368,181,General,Private
111,逢甲大學,1010,773,237,General,Private
111,遠東科技大學,105,98,7,Tech,Private
111,銘傳大學,463,349,114,General,Private
111,長庚大學,251,177,74,General,Private
111,長榮大學,195,167,28,General,Private
111,靜宜大學,512,405,107,General,Private
112,中原大學,510,364,146,General,Private
112,中國文化大學,433,369,64,General,Private
112,中國科技大學,188,164,24,Tech,Private
112,中華大學,459,374,85,General,Private
112,亞洲大學,489,402,87,General,Private
112,健行科技大學,380,347,33,Tech,Private
112,元智大學,676,478,198,General,Private
112,南亞技術學院,169,150,19,Tech,Private
112,南臺科技大學,606,548,58,Tech,Private
112,南華大學,319,251,68,General,Private
112,國立中央大學,427,330,97,General,Public
112,國立中山大學,235,197,38,General,Public
112,國立中正大學,398,313,85,General,Public
112,國立中興大學,139,106,33,General,Public
112,國立勤益科技大學,616,537,79,Tech,Public
112,國立嘉義大學,238,170,68,General,Public
112,國立宜蘭大學,209,170,39,General,Public
112,國立屏東大學,322,273,49,General,Public
112,國立彰化師範大學,222,175,47,General,Public
112,國立成功大學,532,425,107,General,Public
112,國立暨南國際大學,258,196,62,General,Public
112,國立東華大學,536,367,169,General,Public
112,國立清華大學,604,466,138,General,Public
112,國立澎湖科技大學,220,198,22,Tech,Public
112,國立聯合大學,191,157,34,General,Public
112,國立臺中教育大學,202,136,66,General,Public
112,國立臺中科技大學,377,314,63,Tech,Public
112,國立臺北大學,231,194,37,General,Public
112,國立臺北科技大學,270,236,34,Tech,Public
112,國立臺南大學,178,134,44,General,Public
112,國立臺東大學,385,298,87,General,Public
112,國立臺灣大學,616,512,104,General,Public
112,國立臺灣師範大學,252,187,65,General,Public
112,國立臺灣海洋大學,508,403,105,General,Public
112,國立臺灣科技大學,408,350,58,Tech,Public
112,國立虎尾科技大學,460,407,53,Tech,Public
112,國立金門大學,217,167,50,General,Public
112,國立陽明交通大學,827,653,174,General,Public
112,國立雲林科技大學,289,272,17,Tech,Public
112,國立高雄大學,198,160,38,General,Public
112,國立高雄科技大學,296,267,29,Tech,Public
112,大同大學,500,404,96,General,Private
112,大葉大學,113,101,12,General,Private
112,宏國德霖科技大學,82,69,13,Tech,Private
112,崑山科技大學,147,133,14,Tech,Private
112,明新科技大學,318,291,27,Tech,Private
112,景文科技大學,48,43,5,Tech,Private
112,朝陽科技大學,439,411,28,Tech,Private
112,東海大學,614,460,154,General,Private
112,樹德科技大學,192,183,9,Tech,Private
112,正修科技大學,287,274,13,Tech,Private
112,淡江大學,840,682,158,General,Private
112,真理大學,182,151,31,General,Private
112,義守大學,448,369,79,General,Private
112,聖約翰科技大學,22,19,3,Tech,Private
112,臺北城市科技大學,294,283,11,Tech,Private
112,華夏科技大學,56,49,7,Tech,Private
112,萬能科技大學,272,251,21,Tech,Private
112,輔仁大學,535,355,180,General,Private
112,逢甲大學,998,751,247,General,Private
112,遠東科技大學,73,68,5,Tech,Private
112,銘傳大學,476,365,111,General,Private
112,長庚大學,248,172,76,General,Private
112,長榮大學,201,177,24,General,Private
112,靜宜大學,527,412,115,General,Private
